NO image/north.xpm

SO image/south.xpm
F  40    ,    40    ,   40     

EA image/east.xpm
                C 120,160,                     220

WE image/west.xpm


1111111111111111111111111
1000000000110000000000001
1011000001110000000000001
10010000000000000000000011111111
111111111011000001110000000000001
100000000011000001110111101111111
11110111111111011100000010001
11110111111111011101010010001
1100000011 101011100000010001
1000000001110000110000010001
100000000000000011010100100N1
1100000111010101111101111000111
11110111 1110101 101111010001
11111111 1111111 111111111111